11111
11111
11111
11111
11111
11111
11 11
11 11
11111
11111
1   1
1   1
11111
11111

11111
11111
1 1 1
1 1 1
11111
11111
  1
  1
  1
11111
11111
11311
11311
11111
22222
22222
11111
11111
1   1
1   1
1   1
1   1
11111
11111
11111
11411
11111
11111
11111