1111111111
1111111111
1111111111
1111111111
1111111111
1111111111
1112211111
1112211111
1112211111
1112211111
1112211111
1112211111
1112211111
1112211111
1112211111
1112211111
1111111111
1111111111
1111111111
1111111122
1111111122
1111111122
1111111122
1111111122
1111111122
1111111122
1111111122
1111111122
1111111122
1111111122
1111111122
1111111111
1111111111
1111111111
2211111111
2211111111
2211111111
2211111111
2211111111
2211111111
2211111111
2211111111
2211111111
2211111111
2211111111
2211111111
1111111111
1111111111
1111111111
1111133111
1111133111
1111133111
1111133111
1111133111
1111133111
1111133111
1111133111
1111133111
1111133111
1111133111
1111133111
1111111111
1111111111
1111111111
1122111122
1122111122
1122111122
1122111122
1122111122
1122111122
1122111122
1122111122
1111111111
1111111111
1111111111
1111111111