1111111111
1111111111
1111111111
1111111111
1111111111
1111111111
11222  111
11222  111
11222  111
11222  111
11222  111
11222  111
11222  111
11222  111
11222  111
11222  111
11222  111
11222  111
1111111111
1111111111
1111111111
1111111111
111  22211
111  22211
111  22211
111  22211
111  22211
111  22211
111  22211
111  22211
111  22211
111  22211
1111111111
1111111111
1111111111

1111111111
1111111111
33 111 133
33 111 133
33 111 133
33 111 133
33 111 133
33 111 133
33 111 133
33 111 133
33 111 133
33 111 133
33 111 133
33 111 133
1111111111
1111111111
1111111111
1111111111
1122233111
1122233111
1122233111
1122233111
1122233111
1122233111
1122233111
1122233111
1122233111
1122233111
1111111111
1111111111
1111111111
111  33311
111  33311
111  33311
111  33311
111  33311
111  33311
111  33311
111  33311
1111111111
1111111111
1111111111
1111111111