1111111111
1111111111
1111111111
1111111111
1111111111
1111111111
22 111 133
22 111 133
22 111 133
22 111 133
22 111 133
22 111 133
22 111 133
22 111 133
22 111 133
22 111 133
22 111 133
22 111 133
1111111111
1111111111
1111111111

1111111111
1111111111
1333111221
1333111221
1333111221
1333111221
1333111221
1333111221
1333111221
1333111221
1333111221
1333111221
1333111221
1333111221
1111111111
1111111111
1111111111
111  33  1
111  33  1
111  33  1
111  33  1
111  33  1
111  33  1
111  33  1
111  33  1
111  33  1
111  33  1
1111111111
1111111111
1111111111
1111111111
11 2211 33
11 2211 33
11 2211 33
11 2211 33
11 2211 33
11 2211 33
11 2211 33
11 2211 33
11 2211 33
11 2211 33
11 2211 33
11 2211 33
1111111111
1111111111
1111111111
3311122111
3311122111
3311122111
3311122111
3311122111
3311122111
3311122111
3311122111
3311122111
3311122111
1111111111
1111111111
1111111111
1111111111