1111111111
1111111111
1111111111
1111111111
33 11 1122
33 11 1122
33 11 1122
33 11 1122
33 11 1122
33 11 1122
33 11 1122
33 11 1122
33 11 1122
33 11 1122
33 11 1122
33 11 1122
1111111111
1111111111

1111111111
1111111111
1 33 22 11
1 33 22 11
1 33 22 11
1 33 22 11
1 33 22 11
1 33 22 11
1 33 22 11
1 33 22 11
1 33 22 11
1 33 22 11
1 33 22 11
1 33 22 11
1111111111
1111111111
1111111111
22111  133
22111  133
22111  133
22111  133
22111  133
22111  133
22111  133
22111  133
22111  133
22111  133
22111  133
22111  133
1111111111
1111111111
1111111111

1111111111
1111111111
11 33 11 2
11 33 11 2
11 33 11 2
11 33 11 2
11 33 11 2
11 33 11 2
11 33 11 2
11 33 11 2
11 33 11 2
11 33 11 2
11 33 11 2
11 33 11 2
11 33 11 2
11 33 11 2
1111111111
1111111111
1111111111
133  22111
133  22111
133  22111
133  22111
133  22111
133  22111
133  22111
133  22111
1111111111
1111111111
1111111111
1111111111