1111111111
1111111111
1111111111
1111111111
1111111111
1111111111
22 1111 33
22 1111 33
22 1111 33
22 1111 33
22 1111 33
22 1111 33
22 1111 33
22 1111 33
22 1111 33
22 1111 33
22 1111 33
22 1111 33
1111111111
1111111111
1111111111
1 44 11 22
1 44 11 22
1 44 11 22
1 44 11 22
1 44 11 22
1 44 11 22
1 44 11 22
1 44 11 22
1 44 11 22
1 44 11 22
1 44 11 22
1 44 11 22
1111111111
1111111111

1111111111
1111111111
111 33 111
111 33 111
111 33 111
111 33 111
111 33 111
111 33 111
111 33 111
111 33 111
111 33 111
111 33 111
111 33 111
111 33 111
1111111111
1111111111
1111111111
44 111  22
44 111  22
44 111  22
44 111  22
44 111  22
44 111  22
44 111  22
44 111  22
44 111  22
44 111  22
44 111  22
44 111  22
1111111111
1111111111
1111111111
1111111111
1 22 44 11
1 22 44 11
1 22 44 11
1 22 44 11
1 22 44 11
1 22 44 11
1 22 44 11
1 22 44 11
1 22 44 11
1 22 44 11
1111111111
1111111111
1111111111
1111111111