1111111111
1111111111
1111111111
1111111111
1111111111
111222 111
111222 111
111222 111
111222 111
111222 111
111222 111
111222 111
111222 111
111222 111
111222 111
111222 111
111222 111
1111111111
1111111111
1111111111
22111  331
22111  331
22111  331
22111  331
22111  331
22111  331
22111  331
22111  331
22111  331
22111  331
22111  331
22111  331
1111111111
1111111111
1111111111

1111111111
1111111111
1 33 111 2
1 33 111 2
1 33 111 2
1 33 111 2
1 33 111 2
1 33 111 2
1 33 111 2
1 33 111 2
1 33 111 2
1 33 111 2
1111111111
1111111111
1111111111
11 444 111
11 444 111
11 444 111
11 444 111
11 444 111
11 444 111
11 444 111
11 444 111
11 444 111
11 444 111
11 444 111
11 444 111
1111111111
1111111111
1111111111
1111111111
33 1111 22
33 1111 22
33 1111 22
33 1111 22
33 1111 22
33 1111 22
33 1111 22
33 1111 22
33 1111 22
33 1111 22
1111111111
1111111111
1111111111
1111111111